0000000000000
0h11000000000
00010c0100000
0001111f111e0
0000010001000
0000000000000